111111111
100000C01
100000001
10C000E01
1P1001001
111111111