1111111111111
1P01000000001
1000010000001
100C010000E01
111111111111
