1111111111111
1001000P00001
10000100P0E01
100C010000001
1111111111111